222222222222222
1111111111111110000000000000000000000000000000000000000000000000000000000000000000000000000000000000
1111111111111110000000000000000000000000000000000000000000000000000000000000000000000000000000000000
1111111111111110000000000000000000000000000000000000000000000000000000000000000000000000000000000000
1111111111111110000000000000000000000000000000000000000000000000000000000000000000000000000000000000
1111111111111110000000000000000000000000000000000000000000000000000000000000000000000000000000000000
1111111111111110000000000000000000000000000000000000000000000000000000000000000000022220000000000000
1111111111111110000000000000000000000000000000000000000000000000000000000000000000011110000000000000
1111111111111110000000000000000000000000000000000000000000000000000000000000000000011110000000000000
11111111111111100000000000000000000000000000000000000000000000000000000000000000000111100000000000000000
11111111111111100000000000000000000000000000000000000000000000000000000000000000000111100000000000000000
11111111111111100000000000000000000000000222222000000000000000000000000000000000000111100000000000000000
11111111111111100000000000000000000000000111111222200000000000000000000000000000002111100000000000000000
11111111111111100000000000000000000000000111111111122000000000000000000000000000001111122000000000000000000
11111111111111100000000000000000000000000111111111111000000000000000000000000000001111111000000000000000000
1111111111111112222222222222222222222222211111111111122222222222222222222222222222111111122222222222
1111111111111111111111111111111111111111111111111111111111111111111111111111111111111111111111111111
1111111111111111111111111111111111111111111111111111111111111111111111111111111111111111111111111111
1111111111111111111111111111111111111111111111111111111111111111111111111111111111111111111111111111
1111111111111111111111111111111111111111111111111111111111111111111111111111111111111111111111111111
1111111111111111111111111111111111111111111111111111111111111111111111111111111111111111111111111111
1111111111111111111111111111111111111111111111111111111111111111111111111111111111111111111111111111
1111111111111111111111111111111111111111111111111111111111111111111111111111111111111111111111111111
1111111111111111111111111111111111111111111111111111111111111111111111111111111111111111111111111111
1111111111111111111111111111111111111111111111111111111111111111111111111111111111111111111111111111
1111111111111111111111111111111111111111111111111111111111111111111111111111111111111111111111111111
1111111111111111111111111111111111111111111111111111111111111111111111111111111111111111111111111111
1111111111111111111111111111111111111111111111111111111111111111111111111111111111111111111111111111
