222222222222222
1111111111111110000000000000000000000000000000000000000000000000000000000000000000000000000000000000
1111111111111110000000000000000000000000000000000000000000000000000000000000000000000000000000000000
1111111111111110000000000000000000000000000000000000000000000000000000000000000000000000000000000000
1111111111111110000000000000000000000000000000000000000000000000000000000000000000000000000000000000
1111111111111110000000000000000000000000000000000000000000000000000000000000000000000000000000000000
1111111111111110000000000000000000000000000000000000000000000000000000000000000000022220000000000000
1111111111111110000000000000000000000000000000000000000000000000000000000000000000011110000000000000
1111111111111110000000000000000000000000000000000000000000000000000000000000000000011110000000000000
1111111111111110000000000000000000000000000000000000000000000000000000000000000000011110000000000000
1111111111111110000000000000000000000000000000000000000000000000000000000000000000011110000000000000
1111111111111110000000000000000000000000022222200000000000000000000000000000000000011110000000000000
1111111111111110000000000000000000000000011111122220000000000000000000000000000000211110000000000000
1111111111111110000000000000000000000000011111111112200000000000000000000000000000111112200000000000
1111111111111110000000000000000000000000011111111111100000000000000000000000000000111111100000000000
1111111111111112222222222222222222222222211111111111122222222222222222222222222222111111122222222222
1111111111111111111111111111111111111111111111111111111111111111111111111111111111111111111111111111
1111111111111111111111111111111111111111111111111111111111111111111111111111111111111111111111111111
1111111111111111111111111111111111111111111111111111111111111111111111111111111111111111111111111111
1111111111111111111111111111111111111111111111111111111111111111111111111111111111111111111111111111
1111111111111111111111111111111111111111111111111111111111111111111111111111111111111111111111111111
1111111111111111111111111111111111111111111111111111111111111111111111111111111111111111111111111111
1111111111111111111111111111111111111111111111111111111111111111111111111111111111111111111111111111
1111111111111111111111111111111111111111111111111111111111111111111111111111111111111111111111111111
1111111111111111111111111111111111111111111111111111111111111111111111111111111111111111111111111111
1111111111111111111111111111111111111111111111111111111111111111111111111111111111111111111111111111
1111111111111111111111111111111111111111111111111111111111111111111111111111111111111111111111111111
1111111111111111111111111111111111111111111111111111111111111111111111111111111111111111111111111111
